* Glass Rod table Lamp - Glass Rod Table lamp
* pair of prismatic Icicle Pendantants - Pair Icicle Pendants
* Pair of ebonixzed Flared Armed Benches - Ebonized Flared Armed Benches
* Midcentury Chrome and Cyrstal Chandelier - Chrome and Crystal Chandelier
* French Beaded bRass - Beaded Brass Chandelier
* Pair of Mid-2-th Century Chrome Ball Floor Lamps - Chrome Ball Floor Lamp
* italian Chrome nad Cut FGlass Sputnik Chandelier - Chrome and Cut Glass Sputnik
* (On Hold) Maison jansen Style mirred Steel and Brass Coffee Taable - Brass Coffee Table
* Cerused Oak Armed bench - Cerused Oak Armed bench
* Pair of Midcentury Chairs - Mid Century Chairs
* Five Austrian Chrome Slinky Coil Pendants - Slinky Coil Pendants
* Lucite and Steel Console Table or Table Base - Lucite and steel console
* Monderage WalnutSizx-Drawer Dresser in teh Manner of James Mont - Walnut Dresser James Mont
* Pair of Midcentury Slipper Chars - Slipper Chairs
* Mirror Top Faux Bamboo Iron Coffee Table - Mirror Faux Bamboo
* Pair of Ceramic MidCentury lamps - Ceramic Mid Lamps
* Pair of midcentury button Back Chairs - Button Back Chairs
* Large Chorme Gazelle Sculptiure - Chrrome Gazelle Sculpture
* Tall Lucite Shell Sculptrure - Lucite Shell Sculpture
* Pair of widdicomb side chairs - Widdicomb Side Chairs
* Italian Lucite and Brass Swag Chandelier - Lucite and Brass Swag ---------- SPELLING ERROR
* Ebonized Mid-Cenutry Credenza - Ebonized Credenza
* Floating Walnut and Glass Coffee Table - Floating Walnut Coffee Table
* Midcentury Tub Chair - Tub Chair
* Pair of Brass and Frosted Crystal Mazzega Style venini Sconces - Mazzega Style Venini Sconce
* Scolled Iron Mirror - Scrolled Iron Mirror
* Brass Longhorn Wall Sculpture - Brass Longhorn Sculpture ----- On Hold
* pair of Milo baughman Scoop Lounge Chairs for Thayer Coggin - Scoop Lounge Chaairs
* Eight Arm Brass Sputnik Chandelier - Brass Sputnik Chandelier
* Crystal bead and BRass Dome Chandelier - Bead and Brass Dome
* T.H Robsjohn Gibbings Sytle Magazine Rack - Magazine Rack
* Midcentury Drop Leaf Gate Leg Oval Table - Drop Leaf Table
* Gilt Italian heart Back Chair - Heart Back Chair
* Faux Bamboo Coffee table - Faux Bamboo Coffee Table 
* Midcentury brass and wood floral Chandelier - Wood Floral Chandelier
* midcentury cruved front-Ebonized Two Drawer End Table - Curved Front Ebonized
* Pair of itallian Gery Glass Lucite and chorme table lampess - Grey Glass Table Lamp
* Dan Murphy ribbon Sculpture - Ribbon Sculpture
* Fontana Arte Style Mirror - Fontana Arte Mirror
* Twenty Four light sciolari chrome rod chandelier - Sciolari Chrome Rod --------------MIA
* curtis jere windwept brass sculpture - Windswept Brass Sculpture
* Pair of art deco revival chrome and lucite sconces - Art Deco Revival 
* 1930's incised Star Glass and Nickel Chandelier - Incised Star Glass
* Spiraled Brutalist midcentury wall scultpure - Spiraled Brutalist Sculpture
* Mazzega Italian Amber Sconces - Mazzega Amber Sconces
* Curtis Jere Nautilus Sculpture - Nautilus Sculpture
* Baughman Style Otagaon Mirror - Baughman Style Octagon Mirror
* Pair of Polygon Italian Sconces - Polygon Sconces
* Glass Rod Chandelier by Gaetano sciolari for lightolier - Glass Rod Chandelier
* Large Glass Tube Flush Mount Polygon Chandelier in the manner of bakalowits - Flush Mount Polygon Chandelier
* Pair of Custom upholstred Mondrian Benchess - Mondrian Benches Pair
* Pair of monderage bow front walnut end tables - Bow Front Walnut End Tables
* pair of prismatic glass sconces by kindeley - Pair of Prismatic Glass Sconces
* lester Russon Kaleidoscopic Panting - Lester Painting
* Mid-Century grid cerused ash bench - Cerused Ash Bench
* art nouevau swan mirror - Swan Mirror
* pair of glass pendant lights - Glass Pendant Light --------------------- MIA
* pair of french royere style sconces - Royere Style Sconces
* Brutalist Plant Stand - Brutalist Plant Stand
* pair of blue glass lamps - Blue Glass Lamps
* brass Marlin Sculpture - Marlin Sculpture
* Mid-Century Aluminium Frame Mirror - Aluminum Frame Mirror
* Octagon Side Table - Octagon Side Table
* Pair of La Barge Mirror Framed Mirrors - La barge Mirror
* Pair of ben Seibel Canlesticks - Ben Seibel Candlestick
* Sculptural Danish Coffee or Cocktail table - Danish Table
* black Speckle Glazed Ceramic and Lucite Lamp - Black Speckle Glazed
* Brutalist Inspired Abstract Wall art - Brutalist Abstract Art
* Pair of tony paul for Westwood Walnut and Brass lamps - Westwood walnut and brass lamps
* Curtis Jere Windswept Wall Sculpture - Windswept Wall Sculpture
* Chrome and Lucite Sputnik Chandelier - Chrome and Lucite Sputnik -------------------------- HOLD
* Pair of Two-Tier Venni Sconces - Two Tier Venini Sconce
* Triple Ribbon Sculpture by dan Murphy - Triple Ribbon Sculprture
* Sciolari Five-Arm Chrome sputnik chandelier - Five Arm Sputnik
* Five-Globe Glass and Chrome Sputnik chandelier in the syle of kalmar - Five Globe Sputnik
* Silver leaf palm faux bamboo chandelier - Silver Faux Bamboo
* pair of tall brass almps - Tall Brass Lamps -------------------------------------- Descritpioin
* Pair of chrome and upholstered chais in the maner of knoll - Knoll Chairs --------------- HOld
* T.H. Robosjohn-Gibbings Three-Door Credenza - Three Door Credenza --------------- HOld
* 1940's petite Curvaceous Scroll Armed Settee - Scroll Armed Settee
* Lilac 1970's Glam lacqured Scalloped Mirror - Glam Lacqured Mirror
* pair of Brass Canlde Holders - Brass Candle Holders
* Lucite Table Lmap in teh Manner of Karl Springers - Springer Lucite Table Lamp
1960's Chrome and Glass Coffee Table - 1960 Chrome Coffee Table ------------------ HOld
* Oval flat bnar chrome and Glass Side Table - Oval Flat Bar Table 
* Lucite and Glass Coffeee Table - Lucite and Glass Coffee ---------------------- HOLD
* pair of white lacqureed Cabinets - White Lacquered Cabinents ---------------------- HOLD
* Stacked Lucite table Lamp - Stacked Table Lamp
* Table Lamp by Gerald Thurston - Gerald Table Lamp
* Pair of tiered Walnut end tables by - Tiered Walnut End Tables
* Adrian pearsall Teak and glass end table - Teak and Glass End Table
* radiant blue painting - Radiant Painting 